111111111111111111111111111111111111
1***************11*****************1
1*1111*11*11111111111111111111*11111
1P1111*11111111111111111111111111111
1*1111*11111111111111111111111111111
1******11111111111111111111111111111
1*1111*11111111111111111111111111111
1*1111*11111111111111111111111111111
1******11111111111111111111111111111
111111*11111111111111111111111111111
111111*11111111111111111111111111111
111111*11111111111111111111111111111
111111*11111111111111111111111111111